AZPM	Arizona Public Media Classical	Tucson, AZ
IPR	Iowa Public Radio	Iowa City, IA
KBSU	Classical 24 on Boise State Public Radio	Boise, ID
KCNV	Classical 24 on KCNV	Las Vegas, NV
KDFC	Classical KDFC	San Francisco, CA
KLRE	Classical 24 on KLRE	Little Rock, AR
KMFA	Classical Public Radio for Central Texas	Austin, TX
KPAC	Classical KPAC	San Antonio, TX
KPBS	Classical San Diego	San Diego, CA
KUAF	KUAF Classical	Fayetteville, AR
KUER	Classical 24 on KUER	Salt Lake City, UT
KUHA	Classical 91.7FM	Houston, TX
KVOD	Colorado Public Radio Classical	Lakewood, CO
KWMU	Classical 24 on KWMU	St. Louis, MO
KWTU	Classical from the University of Tulsa	Tulsa, OK
KXPR	Capital Public Radio	Sacramento, CA
MPR	Classical MPR	Saint Paul, MN
NIPR	Northeast Indiana Public Radio	Roanoke, IN
VPR	VPR Classical	Burlington, VT
WABE	WABE Classical Radio	Atlanta, GA
WCLV	WCLV Classical 104.9 ideastream	Lorain, OH
WCPE	The Classical Station	Raleigh, NC
WDAV	Classical Public Radio	Davidson, NC
WEKU	Classic 102.1	Richmond, KY
WEMC	Shenandoah Valley Classical	Harrisonburg, VA
WETA	Classical WETA	Washington, DC
WETA	ViveLaVoce	Washington, DC
WCRB	Classical Radio Boston	Boston, MA
WGUC	Cincinnati Public Radio	Cincinnati, OH
WHRO	Connoisseur Classics	Norfolk, VA
WHRO	WHRO Classical	Norfolk, VA
WIAA	Classical IPR	Interlochen, MI
WKMS	Classical 24 on WKMS	Murray, KY
WKSU	WKSU-3: Classical Music	Kent, OH
WMHT	Classical 24 on WMHT	Schenectady, NY
WNIJ	Classical 24 on WNIU	Rockford, IL
WOSU	Classical 101	Grove Ctiy, OH
WPLN	Classical from Nashville Public Radio	Nashville, TN
WPM	Classical 24 on Wyoming Public Radio	Laramie, WY
WQED	Classical QED	Pittsburgh, PA
WQXR	New York's Classical Station	New York, NY
WQXR	Q2: Living Music. Living Composers.	New York, NY
WRKF	Classical 24 on WRKF	Baton Rouge, LA
WRTI	WRTI Classical	Philadelphia, PA
WUIS	Classical 24 on WUIS	Springfield, IL
WUOL	Classical 24 on WUOL	Louisville, KY
WUWF	Classical 24 on WUWF	Pensacola, FL
WWFM	WWFM Classical	Trenton, NJ
WXXI	WXXI Classical	Rochester, NY
WMFE	Classical 24 on WMFE	Orlando, FL
